111111111111111111111111
100000000000000100000001
100100000000000100000001
101000000000000100000001
100000222220000100000001
100000200020000100000001
100000200020000100000001
100000200020000100000001
100000220220000100000001
100000000000000100000001
100000000000000100000001
100000000000001000000001
100000000000000100000001
100000000000000100000001
100000000000000000000001
10000000000W000100000001
100000000000000100000001
100000000000000100000001
111111111110000000001001
100000011110000000001001
100000000010000000001001
100001000010000000001001
100000000010000000001001
111111111111111111111111